#
# 0 O Room3.txt 1
# 1 a Room7.txt 0
#
YY1YYYYYYY
Y    n   Y
Y   T    Y
Y        Y
Y       nY
Y        Y
Y        Y
Yg       Y
Yp     h Y
YYYYYYY0YY